batch,Total GVT Computations,Total All Reduce Calls,Average Reduction / GVT,total events processes,events rolled back,efficiency,total remote network events processed,percent remote events,total rollbacks,primary rollbacks,secondary roll backs,fossil collect attempts,net events processed,remote sends,remote recvs
2,1,4,4.00,30,0,100.000000,2,6.666667,0,0,0,1,30,2,0
2,6746,17873,2.65,107936,4666,95.481747,16171,15.658952,2320,2021,299,6746,103270,18135,17539
2,7377,19451,2.64,118032,4878,95.689061,17413,15.388762,2278,2028,250,7377,113154,19293,18737
2,7390,19463,2.63,118240,4834,95.737439,16894,14.896919,2229,1958,271,7390,113406,18518,18341
2,7399,19578,2.65,118384,5575,95.058018,16730,14.830377,2480,2120,360,7399,112809,18614,18354
2,7367,19443,2.64,117872,4549,95.985810,16906,14.918419,2125,1831,294,7367,113323,18464,18375
2,7391,19553,2.65,118256,5254,95.350525,16678,14.759031,2406,2129,277,7391,113002,18552,17990
2,7375,19555,2.65,118000,4348,96.174286,17007,14.964101,1982,1739,243,7375,113652,18487,18480
2,7413,19719,2.66,118608,5762,94.893926,16995,15.060348,2214,1896,318,7413,112846,18773,18562
2,7395,19665,2.66,118320,5791,94.853771,16795,14.925042,2610,2323,287,7395,112529,18931,18301
2,7371,19553,2.65,117916,4607,95.934127,16953,14.961742,2223,2000,223,7371,113309,18669,18015
2,1,4,4.00,30,0,100.000000,1,3.333333,0,0,0,1,30,1,2
2,6746,17873,2.65,107936,627,99.415706,17966,16.742305,374,350,24,6746,107309,18242,19166
2,7377,19451,2.64,118032,385,99.672750,19182,16.304708,226,217,9,7377,117647,19322,20181
2,7390,19463,2.63,118240,724,99.383914,18667,15.884645,359,336,23,7390,117516,18917,19806
2,7399,19578,2.65,118384,536,99.545177,18845,15.990937,287,271,16,7399,117848,19051,20249
2,7367,19443,2.64,117872,420,99.642407,18617,15.850731,250,234,16,7367,117452,18799,19579
2,7391,19553,2.65,118256,925,99.211632,18707,15.943783,496,461,35,7391,117331,19089,19733
2,7375,19555,2.65,118000,524,99.553951,18742,15.953897,308,303,5,7375,117476,19006,19828
2,7413,19719,2.66,118608,986,99.161721,18717,15.912839,502,452,50,7413,117622,19113,19930
2,7395,19665,2.66,118320,871,99.258402,18839,16.040154,447,424,23,7395,117449,19167,19957
2,7371,19553,2.65,117930,909,99.223216,18573,15.871510,500,475,25,7371,117021,18891,19386
2,1,4,4.00,30,0,100.000000,2,6.666667,0,0,0,1,30,2,1
2,6746,17873,2.65,107936,5314,94.821773,16851,16.420456,2584,2280,304,6746,102622,19213,18054
2,7377,19451,2.64,118032,4971,95.603258,18256,16.147036,2294,2037,257,7377,113061,20212,19392
2,7390,19463,2.63,118240,5212,95.388753,17822,15.767774,2405,2141,264,7390,113028,19920,18823
2,7399,19578,2.65,118384,5652,94.986339,17750,15.745307,2547,2248,299,7399,112732,20206,19011
2,7367,19443,2.64,117872,5268,95.321658,17753,15.765870,2425,2121,304,7367,112604,19969,18772
2,7391,19553,2.65,118256,5722,94.915314,17663,15.695701,2569,2265,304,7391,112534,19701,18800
2,7375,19555,2.65,118000,5171,95.416958,17804,15.779631,2363,2106,257,7375,112829,19904,18780
2,7413,19719,2.66,118608,6299,94.391367,17740,15.795706,2850,2575,275,7413,112309,20140,18859
2,7395,19665,2.66,118320,5961,94.694684,17712,15.763757,2657,2381,276,7395,112359,20086,19027
2,7371,19553,2.65,117890,4659,95.885402,17699,15.630878,2296,2084,212,7371,113231,19315,18711
2,1,4,4.00,30,0,100.000000,0,0.000000,0,0,0,1,30,0,2
2,6746,17873,2.65,107936,546,99.491573,18271,17.013688,314,292,22,6746,107390,18501,19332
2,7377,19451,2.64,118032,925,99.210124,19640,16.770987,529,490,39,7377,117107,20010,20527
2,7390,19463,2.63,118240,854,99.272486,18995,16.181657,474,452,22,7390,117386,19417,19802
2,7399,19578,2.65,118384,1051,99.104259,19212,16.373910,539,498,41,7399,117333,19756,20013
2,7367,19443,2.64,117872,590,99.496939,19030,16.225849,331,314,17,7367,117282,19264,19770
2,7391,19553,2.65,118256,507,99.569423,19087,16.209904,268,245,23,7391,117749,19295,20114
2,7375,19555,2.65,118000,1118,99.043480,19126,16.363512,574,545,29,7375,116882,19506,19815
2,7413,19719,2.66,118608,1109,99.056162,19068,16.228223,551,513,38,7413,117499,19568,20243
2,7395,19665,2.66,118320,664,99.435643,19076,16.213368,380,368,12,7395,117656,19340,20239
2,7371,19553,2.65,117908,367,99.687769,19031,16.190946,207,200,7,7371,117541,19149,19912
4,1,4,4.00,60,0,100.000000,2,3.333333,0,0,0,1,60,2,0
4,3376,9558,2.83,108032,4855,95.294494,16136,15.639144,2210,1892,318,3376,103177,18178,17696
4,3695,10508,2.84,118240,5242,95.360980,17402,15.400273,2477,2188,289,3695,112998,19302,18746
4,3699,10480,2.83,118368,4813,95.761525,16935,14.913478,2207,1920,287,3699,113555,18647,18364
4,3700,10476,2.83,118400,5500,95.128432,16719,14.808680,2482,2099,383,3700,112900,18549,18277
4,3690,10496,2.84,118080,4652,95.898720,16947,14.940755,2099,1809,290,3690,113428,18577,18467
4,3697,10483,2.84,118304,5493,95.130794,16660,14.768063,2542,2272,270,3697,112811,18604,17935
4,3684,10509,2.85,117888,4219,96.288346,16996,14.952186,1922,1710,212,3684,113669,18460,18305
4,3703,10507,2.84,118496,5701,94.945698,16917,14.998005,2320,2001,319,3703,112795,18743,18482
4,3702,10548,2.85,118464,6138,94.535548,16794,14.951124,2677,2369,308,3702,112326,19122,18251
4,3684,10502,2.85,117883,4533,96.000882,16940,14.944861,2146,1901,245,3684,113350,18484,18068
4,1,4,4.00,60,0,100.000000,1,1.666667,0,0,0,1,60,1,2
4,3376,9558,2.83,108032,662,99.383440,17960,16.727205,386,365,21,3376,107370,18260,19249
4,3695,10508,2.84,118240,353,99.700561,19202,16.288480,224,213,11,3695,117887,19310,20367
4,3699,10480,2.83,118368,965,99.178045,18621,15.860753,479,425,54,3699,117403,18917,19798
4,3700,10476,2.83,118400,592,99.497487,18825,15.979390,319,307,12,3700,117808,19059,20113
4,3690,10496,2.84,118080,606,99.484141,18607,15.839250,341,320,21,3690,117474,18827,19808
4,3697,10483,2.84,118304,933,99.205085,18796,16.014177,492,472,20,3697,117371,19140,19991
4,3684,10509,2.85,117888,395,99.663810,18741,15.950737,226,212,14,3684,117493,18877,19873
4,3703,10507,2.84,118496,983,99.163497,18645,15.866330,482,439,43,3703,117513,18989,19885
4,3702,10548,2.85,118464,981,99.164986,18858,16.051684,506,471,35,3702,117483,19224,20118
4,3684,10502,2.85,117882,800,99.316718,18625,15.907654,440,426,14,3684,117082,18921,19376
4,1,4,4.00,60,0,100.000000,2,3.333333,0,0,0,1,60,2,1
4,3376,9558,2.83,108032,5419,94.718993,16847,16.417998,2563,2195,368,3376,102613,19401,18076
4,3695,10508,2.84,118240,5440,95.177305,18213,16.146277,2464,2134,330,3695,112800,20285,19353
4,3699,10480,2.83,118368,5328,95.286624,17831,15.774062,2350,2086,264,3699,113040,19943,18924
4,3700,10476,2.83,118400,5567,95.066160,17751,15.732100,2404,2110,294,3700,112833,20097,18937
4,3690,10496,2.84,118080,5639,94.984925,17748,15.784278,2519,2188,331,3690,112441,20222,18697
4,3697,10483,2.84,118304,5704,94.934281,17649,15.674067,2453,2142,311,3697,112600,19827,18826
4,3684,10509,2.85,117888,5140,95.441161,17859,15.839749,2360,2109,251,3684,112748,19735,18794
4,3703,10507,2.84,118496,6310,94.375412,17615,15.701603,2767,2462,305,3703,112186,19963,18764
4,3702,10548,2.85,118464,6197,94.480123,17752,15.812305,2676,2338,338,3702,112267,20156,19183
4,3684,10502,2.85,117854,4678,95.866615,17741,15.675585,2116,1917,199,3684,113176,19405,18753
4,1,4,4.00,60,0,100.000000,0,0.000000,0,0,0,1,60,0,2
4,3376,9558,2.83,108032,757,99.294337,18240,17.003030,406,360,46,3376,107275,18534,19352
4,3695,10508,2.84,118240,1150,99.017850,19628,16.763174,601,549,52,3695,117090,20068,20499
4,3699,10480,2.83,118368,906,99.228687,19000,16.175444,477,448,29,3699,117462,19428,19849
4,3700,10476,2.83,118400,1137,99.030385,19164,16.342751,554,502,52,3700,117263,19652,20030
4,3690,10496,2.84,118080,806,99.312721,19020,16.218429,422,392,30,3690,117274,19294,19948
4,3697,10483,2.84,118304,592,99.497078,19143,16.262573,321,296,25,3697,117712,19387,20206
4,3684,10509,2.85,117888,1165,99.001911,19115,16.376378,590,551,39,3684,116723,19587,19687
4,3703,10507,2.84,118496,874,99.256942,19096,16.235058,446,398,48,3703,117622,19494,20058
4,3702,10548,2.85,118464,694,99.410716,19103,16.220599,380,360,20,3702,117770,19365,20315
4,3684,10502,2.85,117864,297,99.747378,19013,16.172055,169,166,3,3684,117567,19149,19762
8,1,5,5.00,120,0,100.000000,3,2.500000,0,0,0,1,120,3,2
8,1690,4923,2.91,108160,5000,95.153160,16152,15.657231,2318,1944,374,1690,103160,18300,17803
8,1849,5382,2.91,118336,5183,95.419476,17396,15.373874,2373,2063,310,1849,113153,19356,18899
8,1852,5401,2.92,118528,5156,95.452140,16905,14.911089,2289,1967,322,1852,113372,18801,18461
8,1852,5397,2.91,118528,5745,94.906147,16714,14.819609,2466,2108,358,1852,112783,18784,18144
8,1846,5391,2.92,118144,4766,95.796363,16943,14.943816,2072,1768,304,1846,113378,18703,18406
8,1852,5387,2.91,118528,5568,95.070822,16683,14.768945,2409,2055,354,1852,112960,18551,18111
8,1849,5403,2.92,118336,4803,95.769512,16986,14.961289,2064,1747,317,1849,113533,18690,18443
8,1856,5422,2.92,118784,6138,94.551071,16944,15.041812,2262,1896,366,1856,112646,18954,18474
8,1854,5435,2.93,118656,6222,94.466087,16765,14.910970,2502,2135,367,1854,112434,18963,18303
8,1847,5413,2.93,118200,4780,95.785576,17001,14.989420,2036,1786,250,1847,113420,18749,18156
8,1,5,5.00,120,0,100.000000,3,2.500000,0,0,0,1,120,3,4
8,1690,4923,2.91,108160,891,99.169378,17964,16.746684,458,394,64,1690,107269,18350,19207
8,1849,5382,2.91,118336,545,99.537316,19207,16.306000,290,276,14,1849,117791,19413,20458
8,1852,5401,2.92,118528,1072,99.087318,18650,15.878286,519,451,68,1852,117456,18980,19794
8,1852,5397,2.91,118528,630,99.465640,18827,15.968888,345,319,26,1852,117898,19089,20112
8,1846,5391,2.92,118144,720,99.386837,18645,15.878355,397,365,32,1846,117424,18925,19675
8,1852,5387,2.91,118528,1148,99.021980,18756,15.978872,594,550,44,1852,117380,19148,19879
8,1849,5403,2.92,118336,721,99.386983,18791,15.976704,363,333,30,1849,117615,19053,19873
8,1856,5422,2.92,118784,1287,98.904653,18675,15.894023,588,531,57,1856,117497,19107,19920
8,1854,5435,2.93,118656,1188,98.988661,18857,16.052882,581,524,57,1854,117468,19231,20024
8,1847,5413,2.93,118188,1147,99.020002,18568,15.864526,578,540,38,1847,117041,18970,19318
8,1,5,5.00,120,0,100.000000,4,3.333333,0,0,0,1,120,4,2
8,1690,4923,2.91,108160,5585,94.555204,16851,16.427980,2481,2086,395,1690,102575,19425,18156
8,1849,5382,2.91,118336,5434,95.186976,18222,16.139661,2376,2102,274,1849,112902,20486,19426
8,1852,5401,2.92,118528,5563,95.075466,17821,15.775683,2389,2102,287,1852,112965,20103,19031
8,1852,5397,2.91,118528,5796,94.858603,17749,15.744420,2526,2165,361,1852,112732,19965,19041
8,1846,5391,2.92,118144,5442,95.171337,17766,15.763695,2345,1993,352,1846,112702,20076,18882
8,1852,5387,2.91,118528,6045,94.625855,17677,15.715264,2314,1962,352,1852,112483,19851,18895
8,1849,5403,2.92,118336,5648,94.987931,17836,15.827772,2383,2079,304,1849,112688,19816,18901
8,1856,5422,2.92,118784,6392,94.312762,17655,15.708413,2725,2351,374,1856,112392,20045,19009
8,1854,5435,2.93,118656,6368,94.328869,17725,15.785302,2654,2298,356,1854,112288,19959,19087
8,1847,5413,2.93,118169,5171,95.423813,17717,15.679039,2147,1875,272,1847,112998,19393,18789
8,1,5,5.00,120,0,100.000000,1,0.833333,0,0,0,1,120,1,3
8,1690,4923,2.91,108160,902,99.159037,18233,16.999198,456,401,55,1690,107258,18573,19482
8,1849,5382,2.91,118336,1183,98.990209,19641,16.765256,614,566,48,1849,117153,20153,20625
8,1852,5401,2.92,118528,966,99.178306,19029,16.186353,482,430,52,1852,117562,19489,20087
8,1852,5397,2.91,118528,1402,98.802998,19168,16.365282,676,610,66,1852,117126,19800,20341
8,1846,5391,2.92,118144,768,99.345692,19054,16.233302,413,378,35,1846,117376,19380,20121
8,1852,5387,2.91,118528,827,99.297372,19114,16.239454,424,383,41,1852,117701,19404,20069
8,1849,5403,2.92,118336,1357,98.839963,19173,16.390121,666,617,49,1849,116979,19667,20009
8,1856,5422,2.92,118784,1242,98.943356,19057,16.212928,598,544,54,1856,117542,19533,20236
8,1854,5435,2.93,118656,1208,98.971460,19075,16.241230,591,543,48,1854,117448,19537,20276
8,1847,5413,2.93,118189,449,99.618651,19030,16.162731,248,225,23,1847,117740,19186,20035
16,1,5,5.00,240,0,100.000000,10,4.166667,0,0,0,1,240,10,10
16,858,2530,2.95,109824,6795,93.404770,16170,15.694610,2623,2045,578,858,103029,19150,18391
16,934,2750,2.94,119552,6368,94.373763,17408,15.380266,2542,2038,504,934,113184,19824,19366
16,935,2755,2.95,119680,6383,94.366135,16882,14.900659,2557,2082,475,935,113297,19106,18820
16,934,2748,2.94,119552,6598,94.158684,16791,14.865343,2534,1955,579,934,112954,19001,18713
16,932,2750,2.95,119296,5701,94.981293,16949,14.920551,2275,1887,388,932,113595,18967,18840
16,933,2748,2.95,119424,6575,94.173630,16655,14.758660,2659,2204,455,933,112849,19173,18496
16,929,2744,2.95,118912,5435,95.210483,16970,14.954572,2177,1812,365,929,113477,18820,18643
16,933,2762,2.96,119424,6596,94.153933,16936,15.010458,2464,2048,416,933,112828,19032,18876
16,934,2762,2.96,119552,6976,93.803297,16855,14.972108,2691,2188,503,934,112576,19245,18695
16,931,2755,2.96,119054,5985,94.706772,16902,14.948394,2490,2046,444,931,113069,19120,18513
16,1,5,5.00,240,0,100.000000,13,5.416667,0,0,0,1,240,13,7
16,858,2530,2.95,109824,2671,97.507303,17967,16.767613,1122,860,262,858,107153,19037,20002
16,934,2750,2.94,119552,1902,98.383340,19191,16.311942,835,686,149,934,117650,19887,20996
16,935,2755,2.95,119680,1996,98.303933,18688,15.879814,868,711,157,935,117684,19342,20356
16,934,2748,2.94,119552,1868,98.412698,18753,15.935046,797,637,160,934,117684,19425,20578
16,932,2750,2.95,119296,1785,98.480993,18678,15.894682,750,623,127,932,117511,19338,20291
16,933,2748,2.95,119424,2019,98.280312,18738,15.960138,824,691,133,933,117405,19492,20260
16,929,2744,2.95,118912,1376,98.829295,18836,16.025728,611,513,98,929,117536,19320,20382
16,933,2762,2.96,119424,1827,98.446389,18653,15.861799,747,622,125,933,117597,19223,20214
16,934,2762,2.96,119552,2124,98.191232,18784,15.996185,932,821,111,934,117428,19556,20341
16,931,2755,2.96,119086,2068,98.232751,18634,15.924046,937,801,136,931,117018,19332,19789
16,1,5,5.00,240,0,100.000000,9,3.750000,0,0,0,1,240,9,12
16,858,2530,2.95,109824,7362,92.814897,16882,16.476352,2936,2284,652,858,102462,20108,18914
16,934,2750,2.94,119552,6614,94.143689,18266,16.173476,2630,2150,480,934,112938,21002,19914
16,935,2755,2.95,119680,6467,94.287758,17849,15.765857,2596,2168,428,935,113213,20449,19367
16,934,2748,2.94,119552,7012,93.769326,17711,15.737516,2763,2307,456,934,112540,20513,19279
16,932,2750,2.95,119296,6608,94.136022,17735,15.738144,2619,2104,515,932,112688,20447,19191
16,933,2748,2.95,119424,6778,93.982920,17700,15.712941,2727,2279,448,933,112646,20338,19502
16,929,2744,2.95,118912,6062,94.628268,17856,15.822774,2452,2090,362,929,112850,20268,19153
16,933,2762,2.96,119424,7281,93.507397,17692,15.776286,2848,2401,447,933,112143,20438,19069
16,934,2762,2.96,119552,7175,93.615242,17729,15.776360,2817,2318,499,934,112377,20379,19378
16,931,2755,2.96,119062,5925,94.762986,17729,15.670382,2373,2001,372,931,113137,19817,19155
16,1,5,5.00,240,0,100.000000,8,3.333333,0,0,0,1,240,8,11
16,858,2530,2.95,109824,2689,97.490083,18274,17.056984,1102,832,270,858,107135,19296,20284
16,934,2750,2.94,119552,2488,97.874667,19577,16.723331,1063,836,227,934,117064,20643,21080
16,935,2755,2.95,119680,2269,98.067472,19045,16.220797,993,810,183,935,117411,20021,20375
16,934,2748,2.94,119552,2253,98.079268,19170,16.342850,983,811,172,934,117299,20096,20465
16,932,2750,2.95,119296,2011,98.285373,19073,16.262097,850,695,155,932,117285,19883,20313
16,933,2748,2.95,119424,1720,98.538707,19075,16.205906,731,618,113,933,117704,19721,20466
16,929,2744,2.95,118912,2112,98.191781,19131,16.379281,960,836,124,929,116800,19927,20157
16,933,2762,2.96,119424,1738,98.523189,19071,16.204986,772,662,110,933,117686,19715,20249
16,934,2762,2.96,119552,1929,98.360015,19047,16.193262,838,711,127,934,117623,19757,20523
16,931,2755,2.96,119048,1433,98.781618,19000,16.154402,653,555,98,931,117615,19524,20336
32,1,6,6.00,480,0,100.000000,31,6.458333,0,0,0,1,480,31,26
32,463,1377,2.97,118528,15691,84.741873,16195,15.748223,4436,2753,1683,463,102837,21935,21164
32,492,1453,2.95,125952,12831,88.657278,17419,15.398556,3869,2534,1335,492,113121,21979,21430
32,488,1437,2.94,124928,11913,89.458921,16838,14.898907,3623,2480,1143,488,113015,20890,20351
32,491,1457,2.97,125696,12676,88.784286,16803,14.867280,3764,2537,1227,491,113020,21143,20777
32,484,1427,2.95,123904,10514,90.727577,16845,14.855807,3403,2455,948,484,113390,20365,19762
32,488,1437,2.94,124928,12081,89.294354,16759,14.851082,3704,2547,1157,488,112847,20817,20103
32,483,1427,2.95,123648,10242,90.968732,16965,14.959526,3268,2334,934,483,113406,20423,20132
32,487,1432,2.94,124672,12103,89.248372,16952,15.059208,3604,2498,1106,487,112569,20792,20426
32,485,1421,2.93,124160,11066,90.215219,16994,15.026438,3406,2428,978,485,113094,20576,20049
32,481,1408,2.93,123061,10190,90.971995,16877,14.952468,3275,2347,928,481,112871,20161,19683
32,1,6,6.00,480,0,100.000000,34,7.083333,0,0,0,1,480,34,32
32,463,1377,2.97,118528,11387,89.371949,17952,16.755490,3233,1952,1281,463,107141,22266,23015
32,492,1453,2.95,125952,8185,93.049836,19182,16.288094,2568,1739,829,492,117767,22036,22975
32,488,1437,2.94,124928,7226,93.860767,18766,15.943654,2257,1492,765,488,117702,21196,22396
32,491,1457,2.97,125696,8123,93.091101,18673,15.882048,2454,1600,854,491,117573,21375,22610
32,484,1427,2.95,123904,6308,94.635872,18818,16.002245,2090,1483,607,484,117596,20916,21614
32,488,1437,2.94,124928,7565,93.554187,18707,15.939436,2396,1667,729,488,117363,21257,22000
32,483,1427,2.95,123648,6168,94.749745,18735,15.947395,2061,1466,595,483,117480,20849,21545
32,487,1432,2.94,124672,7225,93.848289,18745,15.960391,2236,1549,687,487,117447,21229,22039
32,485,1421,2.93,124160,6824,94.184223,18803,16.024920,2236,1610,626,485,117336,20971,21862
32,481,1408,2.93,123061,6117,94.769291,18600,15.905049,2079,1536,543,481,116944,20736,21023
32,1,6,6.00,480,0,100.000000,28,5.833333,0,0,0,1,480,28,31
32,463,1377,2.97,118528,16377,83.967852,16813,16.458968,4732,2903,1829,463,102151,22939,21892
32,492,1453,2.95,125952,12796,88.691718,18332,16.200643,3988,2711,1277,492,113156,23016,22149
32,488,1437,2.94,124928,11840,89.530277,17811,15.749682,3743,2671,1072,488,113088,22157,21470
32,491,1457,2.97,125696,13404,88.063264,17714,15.774944,4056,2891,1165,491,112292,22838,21519
32,484,1427,2.95,123904,10791,90.459982,17734,15.678127,3463,2514,949,484,113113,21486,20667
32,488,1437,2.94,124928,12370,89.010110,17784,15.799854,3789,2623,1166,488,112558,22058,21499
32,483,1427,2.95,123648,10881,90.350901,17750,15.740421,3547,2591,956,483,112767,21620,20634
32,487,1432,2.94,124672,12500,88.856399,17702,15.781122,3826,2776,1050,487,112172,22244,20955
32,485,1421,2.93,124160,11091,90.190945,17816,15.756750,3543,2571,972,485,113069,21826,20825
32,481,1408,2.93,123077,9908,91.244952,17665,15.609398,3269,2403,866,481,113169,21023,20461
32,1,6,6.00,480,0,100.000000,30,6.250000,0,0,0,1,480,30,34
32,463,1377,2.97,118528,11674,89.074812,18284,17.111198,3268,1915,1353,463,106854,22522,23591
32,492,1453,2.95,125952,8701,92.579168,19590,16.707747,2698,1821,877,492,117251,22744,23221
32,488,1437,2.94,124928,7604,93.518803,19062,16.247315,2461,1751,710,488,117324,22234,22260
32,491,1457,2.97,125696,8351,92.883378,19179,16.344114,2538,1655,883,491,117345,22359,22809
32,484,1427,2.95,123904,6246,94.691394,19090,16.224991,2120,1576,544,484,117658,21228,21952
32,488,1437,2.94,124928,7206,93.878799,19056,16.187289,2275,1590,685,488,117722,21654,22184
32,483,1427,2.95,123648,6769,94.208540,19158,16.391311,2288,1629,659,483,116879,21364,21945
32,487,1432,2.94,124672,7003,94.048560,19082,16.216676,2196,1481,715,487,117669,21384,22229
32,485,1421,2.93,124160,6473,94.499817,19180,16.297467,2138,1513,625,485,117687,21384,22021
32,481,1408,2.93,123070,5739,95.108710,19022,16.212254,1964,1440,524,481,117331,20854,21607
64,1,5,5.00,960,20,97.872340,101,10.744681,9,8,1,1,940,109,100
64,375,1124,3.00,192000,89559,12.575043,16036,15.653889,15778,5445,10333,375,102441,45680,44847
64,371,1112,3.00,189952,77022,31.796688,17286,15.306827,13716,5167,8549,371,112930,41084,40806
64,366,1097,3.00,187392,74188,34.465213,16824,14.861666,12615,4988,7627,366,113204,39858,39387
64,372,1114,2.99,190464,77671,31.138457,16790,14.885676,13430,5165,8265,372,112793,40026,39109
64,381,1140,2.99,195072,82173,27.215476,16857,14.931045,14273,5034,9239,381,112899,40693,41257
64,369,1107,3.00,188928,75712,33.126060,16949,14.970499,13393,4922,8471,369,113216,39513,38504
64,365,1095,3.00,186880,74291,34.015756,16811,14.931299,13181,4861,8320,365,112589,38495,38373
64,364,1090,2.99,186368,73311,35.155718,16964,15.004821,13277,4943,8334,364,113057,38866,38097
64,382,1141,2.99,195584,82521,27.013258,16819,14.875777,14104,5086,9018,382,113063,41249,40445
64,374,1120,2.99,190660,78054,30.683978,16768,14.890858,13679,4922,8757,374,112606,39814,39277
64,1,5,5.00,960,11,98.840885,106,11.169652,6,6,0,1,949,118,120
64,375,1124,3.00,192000,85181,20.256696,18005,16.855616,15235,5350,9885,375,106819,47625,49048
64,371,1112,3.00,189952,72538,38.220314,18990,16.173540,12914,4910,8004,371,117414,42452,43982
64,366,1097,3.00,187392,69178,41.480704,18774,15.881368,12467,4930,7537,366,118214,41274,41849
64,372,1114,2.99,190464,72741,38.210035,18854,16.015562,12904,4890,8014,372,117723,42070,43262
64,381,1140,2.99,195072,77747,33.733646,18598,15.851694,13517,4955,8562,381,117325,43186,44512
64,369,1107,3.00,188928,71336,39.336009,18853,16.032553,12832,4777,8055,369,117592,40099,42165
64,365,1095,3.00,186880,68931,41.558640,18865,15.994201,12269,4677,7592,365,117949,39969,41802
64,364,1090,2.99,186368,68654,41.677286,18746,15.925039,12210,4646,7564,364,117714,39834,41310
64,382,1141,2.99,195584,77864,33.856609,18859,16.020217,13776,5071,8705,382,117720,43125,44213
64,374,1120,2.99,190676,73390,37.426462,18577,15.839060,12938,4801,8137,374,117286,40557,42461
64,1,5,5.00,960,10,98.947368,107,11.263158,5,5,0,1,950,113,112
64,375,1124,3.00,192000,89840,12.059514,16880,16.523101,15759,5704,10055,375,102160,49078,46824
64,371,1112,3.00,189952,76821,32.095535,18276,16.154723,13567,5314,8253,371,113131,44608,42537
64,366,1097,3.00,187392,74539,33.950360,17748,15.726653,13499,5246,8253,366,112853,42338,41231
64,372,1114,2.99,190464,77995,30.652002,17666,15.707439,13893,5217,8676,372,112469,42922,41202
64,381,1140,2.99,195072,82799,26.252082,17755,15.814132,14629,5332,9297,381,112273,44423,42466
64,369,1107,3.00,188928,76457,32.020699,17722,15.756951,13653,5057,8596,369,112471,41730,39744
64,365,1095,3.00,186880,74055,34.362951,17848,15.819189,13275,5063,8212,365,112825,41264,39537
64,364,1090,2.99,186368,73404,35.020006,17689,15.658971,13130,5001,8129,364,112964,40767,39253
64,382,1141,2.99,195584,82654,26.809528,17772,15.737182,14437,5269,9168,382,112930,43900,42337
64,374,1120,2.99,190630,78544,29.925236,17472,15.588031,13920,5168,8752,374,112086,41584,39984
64,1,5,5.00,960,54,94.039735,105,11.589404,13,5,8,1,906,115,123
64,375,1124,3.00,192000,85366,19.944858,18281,17.143688,15053,5374,9679,375,106634,48267,49931
64,371,1112,3.00,189952,73029,37.540946,19274,16.484353,13094,5069,8025,371,116923,43190,44009
64,366,1097,3.00,187392,69494,41.055828,19205,16.289504,12471,4886,7585,366,117898,42125,43128
64,372,1114,2.99,190464,72584,38.425517,19242,16.323380,12931,5083,7848,372,117880,42794,44239
64,381,1140,2.99,195072,77943,33.455421,18983,16.206917,13693,5284,8409,381,117129,44251,44318
64,369,1107,3.00,188928,70945,39.868456,19202,16.275226,12633,4968,7665,369,117983,41410,42339
64,365,1095,3.00,186880,70272,39.736553,18840,16.156696,12554,4996,7558,365,116608,40582,40598
64,364,1090,2.99,186368,68555,41.810327,19144,16.249480,12244,4864,7380,364,117813,40756,41563
64,382,1141,2.99,195584,77765,33.996215,19180,16.279208,13724,5117,8607,382,117819,43684,44963
64,374,1120,2.99,190610,73916,36.658269,18976,16.261333,13346,5020,8326,374,116694,42728,42961
128,1,6,6.00,1920,402,73.517787,206,13.570487,79,39,40,1,1518,382,374
128,299,897,3.00,306176,204313,-100.576264,15977,15.684792,28295,8250,20045,299,101863,82475,82661
128,301,902,3.00,308224,195226,-72.769430,17129,15.158675,26884,8051,18833,301,112998,77383,78231
128,313,939,3.00,320512,207051,-82.486493,16847,14.848274,28034,8452,19582,313,113461,80203,81634
128,310,930,3.00,317440,203717,-79.134388,17109,15.044450,28171,8110,20061,310,113723,79301,79811
128,312,936,3.00,319488,206392,-82.492750,16992,15.024404,27977,8222,19755,312,113096,79342,78518
128,311,932,3.00,318464,206023,-83.227648,16808,14.948284,28400,8386,20014,311,112441,78436,77206
128,302,906,3.00,309248,196557,-74.421205,16969,15.057990,27427,8221,19206,302,112691,77057,75001
128,318,954,3.00,325632,212275,-87.262366,17165,15.142426,29703,8521,21182,318,113357,81863,80459
128,313,939,3.00,320512,206977,-82.302374,16898,14.883516,28675,8076,20599,313,113535,77574,78707
128,315,944,3.00,320500,206779,-81.830093,16959,14.912813,28566,8119,20447,315,113721,78941,78231
128,1,6,6.00,1920,310,80.745342,235,14.596273,60,29,31,1,1610,335,370
128,299,897,3.00,306176,199935,-88.190058,17823,16.776009,28472,8556,19916,299,106241,87245,89336
128,301,902,3.00,308224,190493,-61.803603,19087,16.212382,27200,8432,18768,301,117731,80565,84659
128,313,939,3.00,320512,203020,-72.794743,18601,15.831716,28085,8371,19714,313,117492,82479,86144
128,310,930,3.00,317440,199777,-69.787444,18827,16.000782,27686,8464,19222,310,117663,82461,84832
128,312,936,3.00,319488,201726,-71.299740,18815,15.977140,28466,8601,19865,312,117762,82533,84604
128,311,932,3.00,318464,200398,-69.733878,18892,16.001220,28016,8444,19572,311,118066,83178,84907
128,302,906,3.00,309248,191941,-63.622802,18639,15.889077,27105,8522,18583,302,117307,78847,81003
128,318,954,3.00,325632,207567,-75.807394,18677,15.819252,29215,8531,20684,318,118065,83409,85697
128,313,939,3.00,320512,203375,-73.621486,18713,15.975311,28645,8640,20005,313,117137,82631,84726
128,315,944,3.00,320580,203703,-74.288354,18521,15.846574,29316,8669,20647,315,116877,82675,83765
128,1,6,6.00,1920,323,79.774577,238,14.902943,60,38,22,1,1597,392,373
128,299,897,3.00,306176,204256,-100.408163,16892,16.573783,28966,8902,20064,299,101920,89270,86424
128,301,902,3.00,308224,196066,-74.812318,18096,16.134382,27229,8677,18552,301,112158,84210,79648
128,313,939,3.00,320512,207999,-84.866638,17572,15.617751,27986,8761,19225,313,112513,85932,81604
128,310,930,3.00,317440,204723,-81.625664,17828,15.816603,28225,8736,19489,310,112717,84084,80909
128,312,936,3.00,319488,206161,-81.916931,17892,15.787941,28399,8538,19861,312,113327,83072,81684
128,311,932,3.00,318464,205342,-81.522604,17796,15.731688,28515,8556,19959,311,113122,82636,80861
128,302,906,3.00,309248,196659,-74.669817,17822,15.829255,27652,8577,19075,302,112589,80200,78103
128,318,954,3.00,325632,212751,-88.473702,17972,15.921191,29353,8850,20503,318,112881,85614,83316
128,313,939,3.00,320512,207737,-84.204833,17963,15.928176,28199,8686,19513,313,112775,84901,80931
128,315,944,3.00,320396,207436,-83.636686,17667,15.640050,29014,8802,20212,315,112960,83339,80901
128,1,6,6.00,1920,419,72.085276,209,13.924051,71,47,24,1,1501,389,381
128,299,897,3.00,306176,200005,-88.380066,18079,17.028190,28140,8875,19265,299,106171,89635,90204
128,301,902,3.00,308224,191371,-63.770720,19418,16.617460,26643,8766,17877,301,116853,83948,83568
128,313,939,3.00,320512,203551,-74.033225,19024,16.265251,27812,8810,19002,313,116961,86612,85844
128,310,930,3.00,317440,199895,-70.058276,19172,16.310349,27876,8883,18993,310,117545,84836,85130
128,312,936,3.00,319488,202082,-72.122379,19097,16.265779,28379,8827,19552,312,117406,84599,84740
128,311,932,3.00,318464,201112,-71.375009,19184,16.347399,27909,8587,19322,311,117352,84280,85556
128,302,906,3.00,309248,192571,-65.046239,19085,16.357123,27243,8603,18640,302,116677,80793,82790
128,318,954,3.00,325632,208040,-76.916797,19184,16.314035,28104,8984,19120,318,117592,86128,87542
128,313,939,3.00,320512,204239,-75.654709,18889,16.245388,27524,8817,18707,313,116273,84091,84833
128,315,944,3.00,320550,203474,-73.796508,18919,16.159589,28251,8999,19252,315,117076,83413,85471
