gvt,Total GVT Computations,Total All Reduce Calls,Average Reduction / GVT,total events processes,events rolled back,efficiency,total remote network events processed,percent remote events,total rollbacks,primary rollbacks,secondary roll backs,fossil collect attempts,net events processed,remote sends,remote recvs
2,1,4,4.00,48,0,100.000000,2,4.166667,0,0,0,1,48,2,0
2,3379,8688,2.57,108128,5042,95.108938,16125,15.642279,2400,2058,342,3379,103086,18301,17615
2,3695,9485,2.57,118240,5142,95.453501,17402,15.386656,2354,2032,322,3695,113098,19422,18760
2,3706,9507,2.57,118592,5162,95.449176,16942,14.936084,2227,1881,346,3706,113430,18510,18515
2,3713,9558,2.57,118816,5917,94.759032,16759,14.844241,2505,2091,414,3713,112899,18633,18542
2,3693,9478,2.57,118176,4823,95.745150,16907,14.915353,2117,1846,271,3693,113353,18559,18423
2,3698,9453,2.56,118336,5491,95.134033,16637,14.743232,2369,2030,339,3698,112845,18671,18036
2,3700,9546,2.58,118400,4680,95.884629,17002,14.950756,1955,1689,266,3700,113720,18674,18648
2,3710,9619,2.59,118720,6076,94.606015,16968,15.063386,2373,2003,370,3710,112644,19216,18480
2,3717,9697,2.61,118944,6342,94.367773,16805,14.924246,2682,2222,460,3717,112602,18971,18583
2,3701,9507,2.57,118405,5024,95.568922,16933,14.934601,2332,2087,245,3701,113381,18691,18403
2,1,4,4.00,48,0,100.000000,1,2.083333,0,0,0,1,48,1,2
2,3379,8688,2.57,108128,717,99.332471,18015,16.772025,419,365,54,3379,107411,18331,19328
2,3695,9485,2.57,118240,472,99.599212,19187,16.292202,292,273,19,3695,117768,19337,20292
2,3706,9507,2.57,118592,1251,98.933876,18599,15.850385,612,555,57,3706,117341,19019,19864
2,3713,9558,2.57,118816,1028,99.127246,18799,15.960030,499,461,38,3713,117788,19143,20400
2,3693,9478,2.57,118176,790,99.327007,18630,15.870717,412,382,30,3693,117386,18912,19737
2,3698,9453,2.56,118336,948,99.192422,18780,15.998228,497,467,30,3698,117388,19096,19868
2,3700,9546,2.58,118400,931,99.207450,18718,15.934417,476,431,45,3700,117469,19078,19943
2,3710,9619,2.59,118720,1179,98.996946,18704,15.912745,585,539,46,3710,117541,19122,19981
2,3717,9697,2.61,118944,1564,98.667575,18788,16.006134,793,742,51,3717,117380,19378,20133
2,3701,9507,2.57,118412,1339,98.856269,18602,15.889232,711,660,51,3701,117073,19116,19584
2,1,4,4.00,48,0,100.000000,2,4.166667,0,0,0,1,48,2,1
2,3379,8688,2.57,108128,5517,94.623383,16852,16.423190,2615,2265,350,3379,102611,19370,18222
2,3695,9485,2.57,118240,5296,95.310951,18226,16.137201,2422,2096,326,3695,112944,20230,19401
2,3706,9507,2.57,118592,5523,95.115372,17843,15.780630,2535,2248,287,3706,113069,20129,19009
2,3713,9558,2.57,118816,5987,94.693740,17716,15.701637,2619,2297,322,3713,112829,20458,18951
2,3693,9478,2.57,118176,5397,95.214535,17795,15.778647,2397,2111,286,3693,112779,20061,18797
2,3698,9453,2.56,118336,5913,94.740400,17641,15.691629,2591,2269,322,3698,112423,19805,18922
2,3700,9546,2.58,118400,5774,94.873297,17874,15.870225,2644,2349,295,3700,112626,20114,18985
2,3710,9619,2.59,118720,6341,94.357487,17681,15.733367,2734,2401,333,3710,112379,19959,19072
2,3717,9697,2.61,118944,6680,94.049740,17710,15.775315,2736,2341,395,3717,112264,20330,19227
2,3701,9507,2.57,118400,5193,95.412828,17704,15.638609,2314,2071,243,3701,113207,19820,18806
2,1,4,4.00,48,0,100.000000,0,0.000000,0,0,0,1,48,0,2
2,3379,8688,2.57,108128,785,99.268699,18248,16.999711,446,394,52,3379,107343,18550,19387
2,3695,9485,2.57,118240,1040,99.112628,19664,16.778157,582,524,58,3695,117200,20094,20630
2,3706,9507,2.57,118592,1116,99.050019,19022,16.192244,645,602,43,3706,117476,19524,19794
2,3713,9558,2.57,118816,1510,98.712768,19219,16.383646,816,754,62,3713,117306,19947,20288
2,3693,9478,2.57,118176,924,99.211954,18982,16.189063,485,441,44,3693,117252,19346,19921
2,3698,9453,2.56,118336,627,99.467330,19101,16.227306,347,321,26,3698,117709,19367,20113
2,3700,9546,2.58,118400,1493,98.722917,19124,16.358302,743,684,59,3700,116907,19728,20018
2,3710,9619,2.59,118720,1174,99.001242,19081,16.232794,592,552,40,3710,117546,19549,20313
2,3717,9697,2.61,118944,1314,98.882938,19070,16.211851,604,554,50,3717,117630,19612,20348
2,3701,9507,2.57,118385,686,99.417157,19005,16.147121,382,360,22,3701,117699,19247,20081
4,1,4,4.00,112,0,100.000000,2,1.785714,0,0,0,1,112,2,0
4,1703,4864,2.86,108992,5816,94.363030,16176,15.678065,2460,2049,411,1703,103176,18618,17974
4,1852,5286,2.85,118528,5471,95.160848,17418,15.406388,2443,2064,379,1852,113057,19438,19018
4,1859,5345,2.88,118976,5582,95.077341,16916,14.917897,2326,1927,399,1859,113394,18800,18634
4,1857,5336,2.87,118848,5900,94.776357,16736,14.817438,2451,2051,400,1857,112948,18814,18531
4,1845,5279,2.86,118080,4669,95.883115,16934,14.931532,2054,1744,310,1845,113411,18666,18444
4,1854,5339,2.88,118656,5780,94.879337,16689,14.785251,2433,2082,351,1854,112876,18909,18197
4,1853,5321,2.87,118592,4887,95.702036,16980,14.933380,2082,1798,284,1853,113705,18710,18535
4,1855,5347,2.88,118720,6024,94.654646,16957,15.046674,2474,2131,343,1855,112696,18951,18609
4,1851,5353,2.89,118464,5880,94.777233,16786,14.909756,2567,2206,361,1851,112584,18894,18305
4,1850,5318,2.87,118268,5093,95.499890,16936,14.964436,2224,1947,277,1850,113175,18828,18279
4,1,4,4.00,112,0,100.000000,1,0.892857,0,0,0,1,112,1,2
4,1703,4864,2.86,108992,1671,98.442989,18002,16.773977,807,665,142,1703,107321,18732,19533
4,1852,5286,2.85,118528,719,99.389690,19207,16.303508,369,327,42,1852,117809,19463,20508
4,1859,5345,2.88,118976,1571,98.661897,18623,15.862186,709,606,103,1859,117405,19127,19848
4,1857,5336,2.87,118848,1096,99.069230,18760,15.931789,515,462,53,1857,117752,19120,20354
4,1845,5279,2.86,118080,763,99.349625,18603,15.857037,445,399,46,1845,117317,18887,19540
4,1854,5339,2.88,118656,1304,98.888813,18768,15.992910,661,601,60,1854,117352,19258,19958
4,1853,5321,2.87,118592,1157,99.014774,18722,15.942436,576,506,70,1853,117435,19118,20037
4,1855,5347,2.88,118720,1135,99.034741,18727,15.926351,581,530,51,1855,117585,19123,20009
4,1851,5353,2.89,118464,1184,98.990450,18821,16.047920,561,504,57,1851,117280,19239,20058
4,1850,5318,2.87,118338,1341,98.853817,18605,15.902117,660,596,64,1850,116997,19139,19537
4,1,4,4.00,112,0,100.000000,3,2.678571,0,0,0,1,112,3,1
4,1703,4864,2.86,108992,6335,93.828964,16870,16.433365,2742,2237,505,1703,102657,19622,18472
4,1852,5286,2.85,118528,5630,95.013198,18225,16.142890,2559,2181,378,1852,112898,20539,19528
4,1859,5345,2.88,118976,5932,94.752486,17810,15.754927,2493,2137,356,1859,113044,20166,19151
4,1857,5336,2.87,118848,6030,94.655108,17763,15.744828,2588,2264,324,1857,112818,20445,19111
4,1845,5279,2.86,118080,5435,95.175108,17743,15.751254,2326,1973,353,1845,112645,19881,18818
4,1854,5339,2.88,118656,6031,94.645061,17674,15.692786,2499,2114,385,1854,112625,19942,19102
4,1853,5321,2.87,118592,5914,94.751416,17811,15.806990,2445,2105,340,1853,112678,19989,19017
4,1855,5347,2.88,118720,6499,94.208749,17663,15.739478,2709,2358,351,1855,112221,20113,18901
4,1851,5353,2.89,118464,5989,94.675261,17747,15.778617,2460,2134,326,1851,112475,20035,19100
4,1850,5318,2.87,118292,5047,95.543291,17718,15.645724,2258,1987,271,1850,113245,19600,18861
4,1,4,4.00,112,0,100.000000,0,0.000000,0,0,0,1,112,0,3
4,1703,4864,2.86,108992,1564,98.544141,18283,17.018841,721,605,116,1703,107428,18881,19874
4,1852,5286,2.85,118528,1443,98.767562,19629,16.764744,693,609,84,1852,117085,20207,20593
4,1859,5345,2.88,118976,1449,98.767092,19046,16.205638,722,638,84,1859,117527,19714,20174
4,1857,5336,2.87,118848,1686,98.560967,19166,16.358546,817,728,89,1857,117162,19952,20335
4,1845,5279,2.86,118080,765,99.347909,19043,16.232366,412,368,44,1845,117315,19311,19943
4,1854,5339,2.88,118656,1019,99.133776,19097,16.233838,507,451,56,1854,117637,19465,20317
4,1853,5321,2.87,118592,1688,98.556080,19113,16.349312,806,739,67,1853,116904,19755,19983
4,1855,5347,2.88,118720,1083,99.079371,19170,16.295893,585,535,50,1855,117637,19568,20236
4,1851,5353,2.89,118464,908,99.227602,19025,16.183776,450,407,43,1851,117556,19417,20122
4,1850,5318,2.87,118289,592,99.497014,18987,16.132102,314,280,34,1850,117697,19195,20085
8,1,5,5.00,240,0,100.000000,10,4.166667,0,0,0,1,240,10,10
8,858,2526,2.94,109824,6796,93.403735,16155,15.680203,2648,2139,509,858,103028,18967,18349
8,935,2759,2.95,119680,6672,94.095993,17385,15.383867,2662,2172,490,935,113008,20051,19454
8,934,2749,2.94,119552,6259,94.475387,16905,14.921487,2524,2036,488,934,113293,19053,18738
8,933,2735,2.93,119424,6355,94.379538,16801,14.859068,2514,2022,492,933,113069,19049,18792
8,929,2729,2.94,118912,5410,95.233564,16948,14.931895,2230,1869,361,929,113502,18884,18775
8,931,2734,2.94,119168,6532,94.200788,16598,14.735964,2656,2219,437,931,112636,18980,18307
8,932,2743,2.94,119296,5584,95.089349,17024,14.971155,2201,1841,360,932,113712,18970,18872
8,933,2759,2.96,119424,6688,94.067556,16926,15.013838,2474,2026,448,933,112736,19052,18674
8,932,2739,2.94,119296,6848,93.910074,16804,14.943796,2633,2180,453,932,112448,19156,18482
8,929,2717,2.92,118850,5623,95.033870,16925,14.947848,2227,1835,392,929,113227,18751,18387
8,1,5,5.00,240,0,100.000000,13,5.416667,0,0,0,1,240,13,7
8,858,2526,2.94,109824,2633,97.543637,17998,16.790589,1105,852,253,858,107191,19118,20056
8,935,2759,2.95,119680,1870,98.412698,19229,16.322044,788,637,151,935,117810,19973,20840
8,934,2749,2.94,119552,2072,98.236296,18620,15.849506,882,715,167,934,117480,19302,20214
8,933,2735,2.93,119424,1767,98.498177,18758,15.942953,755,601,154,933,117657,19336,20470
8,929,2729,2.94,118912,1408,98.801743,18658,15.878608,654,562,92,929,117504,19194,19950
8,931,2734,2.94,119168,1750,98.509598,18798,16.009470,810,700,110,931,117418,19378,20204
8,932,2743,2.94,119296,1746,98.514675,18781,15.977031,749,635,114,932,117550,19361,20283
8,933,2759,2.96,119424,1885,98.396277,18643,15.861118,790,663,127,933,117539,19261,20294
8,932,2739,2.94,119296,1978,98.313984,18802,16.026526,837,726,111,932,117318,19504,20301
8,929,2717,2.92,118870,1961,98.322627,18616,15.923496,902,759,143,929,116909,19286,19684
8,1,5,5.00,240,0,100.000000,9,3.750000,0,0,0,1,240,9,12
8,858,2526,2.94,109824,7280,92.900609,16859,16.440747,2878,2272,606,858,102544,20067,18875
8,935,2759,2.95,119680,6702,94.067872,18275,16.175716,2693,2221,472,935,112978,21005,20066
8,934,2749,2.94,119552,6495,94.255110,17826,15.767268,2537,2073,464,934,113057,20392,19395
8,933,2735,2.93,119424,6953,93.817962,17684,15.723164,2788,2303,485,933,112471,20550,19281
8,929,2729,2.94,118912,6146,94.549776,17724,15.717504,2496,2035,461,929,112766,20306,19048
8,931,2734,2.94,119168,6933,93.822783,17670,15.743752,2673,2183,490,931,112235,20110,19196
8,932,2743,2.94,119296,6358,94.370362,17918,15.865342,2533,2149,384,932,112938,20322,19250
8,933,2759,2.96,119424,7412,93.382852,17576,15.691176,2934,2448,486,933,112012,20234,18964
8,932,2739,2.94,119296,6631,94.114410,17798,15.797275,2607,2188,419,932,112665,20362,19372
8,929,2717,2.92,118836,5768,94.898645,17691,15.646337,2334,1953,381,929,113068,19767,18980
8,1,5,5.00,240,0,100.000000,8,3.333333,0,0,0,1,240,8,11
8,858,2526,2.94,109824,2834,97.351154,18219,17.028694,1145,919,226,858,106990,19329,20201
8,935,2759,2.95,119680,2502,97.864787,19605,16.730956,1089,865,224,935,117178,20571,21240
8,934,2749,2.94,119552,2032,98.270933,19050,16.210007,877,732,145,934,117520,19958,20358
8,933,2735,2.93,119424,2148,98.168423,19199,16.370783,970,805,165,933,117276,20111,20503
8,929,2729,2.94,118912,1478,98.741421,19066,16.235502,685,591,94,929,117434,19642,20253
8,931,2734,2.94,119168,1476,98.745879,19076,16.208408,653,551,102,931,117692,19678,20439
8,932,2743,2.94,119296,2464,97.890989,19126,16.370515,1084,947,137,932,116832,19978,20226
8,933,2759,2.96,119424,1808,98.462794,19149,16.280948,782,661,121,933,117616,19755,20370
8,932,2739,2.94,119296,1749,98.512085,18963,16.132270,766,638,128,932,117547,19579,20446
8,929,2717,2.92,118850,1204,98.976591,19006,16.155245,540,454,86,929,117646,19430,20183
16,1,5,5.00,496,0,100.000000,31,6.250000,0,0,0,1,496,31,26
16,434,1290,2.97,111104,8196,92.035605,16151,15.694601,2882,2115,767,434,102908,19355,18833
16,473,1406,2.97,121088,7975,92.949528,17401,15.383731,2925,2240,685,473,113113,20341,19620
16,470,1391,2.96,120320,7185,93.649180,16857,14.899898,2648,2051,597,470,113135,19367,19071
16,472,1408,2.98,120832,7972,92.936381,16763,14.852915,2806,2137,669,472,112860,19573,19057
16,471,1396,2.96,120576,6919,93.912386,16943,14.907133,2514,1941,573,471,113657,19277,19005
16,471,1407,2.99,120576,7769,93.113016,16664,14.772133,2819,2170,649,471,112807,19372,18861
16,473,1411,2.98,121088,7569,93.332394,17019,14.992204,2768,2106,662,473,113519,19545,19484
16,472,1405,2.98,120832,8039,92.872785,16894,14.977880,2876,2211,665,472,112793,19544,19123
16,471,1404,2.98,120576,8099,92.799417,16837,14.969283,2918,2306,612,471,112477,19569,18922
16,473,1400,2.96,120890,7638,93.255748,16921,14.941016,2705,2076,629,473,113252,19449,19066
16,1,5,5.00,496,0,100.000000,34,6.854839,0,0,0,1,496,34,32
16,434,1290,2.97,111104,4174,96.096512,17956,16.792294,1555,1106,449,434,106930,19648,20480
16,473,1406,2.97,121088,3067,97.401310,19224,16.288627,1158,907,251,473,118021,20392,21210
16,470,1391,2.96,120320,3066,97.385164,18642,15.898818,1201,956,245,470,117254,19738,20592
16,472,1408,2.98,120832,2994,97.459224,18783,15.939680,1140,898,242,472,117838,19845,20960
16,471,1396,2.96,120576,2893,97.541701,18718,15.905441,1140,913,227,471,117683,19652,20511
16,471,1407,2.99,120576,3391,97.106285,18775,16.021675,1320,1092,228,471,117185,20033,20702
16,473,1411,2.98,121088,3347,97.157320,18817,15.981689,1236,972,264,473,117741,19937,20976
16,472,1405,2.98,120832,3158,97.316315,18636,15.836973,1209,963,246,472,117674,19736,20812
16,471,1404,2.98,120576,3232,97.245705,18838,16.053654,1282,1068,214,471,117344,20010,20607
16,473,1400,2.96,120881,3940,96.630780,18587,15.894340,1440,1131,309,473,116941,19939,20362
16,1,5,5.00,496,0,100.000000,28,5.645161,0,0,0,1,496,28,31
16,434,1290,2.97,111104,8939,91.250428,16841,16.484119,3239,2419,820,434,102165,20551,19361
16,473,1406,2.97,121088,8073,92.856700,18271,16.166881,2976,2290,686,473,113015,21247,20552
16,470,1391,2.96,120320,7516,93.337116,17796,15.776036,2848,2247,601,470,112804,20760,19769
16,472,1408,2.98,120832,8258,92.664381,17689,15.713220,3063,2429,634,472,112574,20899,19902
16,471,1396,2.96,120576,7536,93.333333,17789,15.736907,2796,2169,627,471,113040,20661,19419
16,471,1407,2.99,120576,8357,92.552954,17677,15.752234,3016,2335,681,471,112219,20701,19826
16,473,1411,2.98,121088,8175,92.759912,17873,15.829001,2994,2390,604,473,112913,20935,19812
16,472,1405,2.98,120832,9063,91.891312,17567,15.717238,3257,2538,719,472,111769,20803,19399
16,471,1404,2.98,120576,7848,93.038109,17759,15.753850,2940,2366,574,471,112728,20621,19808
16,473,1400,2.96,120898,7892,93.016300,17733,15.692087,2847,2244,603,473,113006,20453,19747
16,1,5,5.00,496,0,100.000000,30,6.048387,0,0,0,1,496,30,34
16,434,1290,2.97,111104,4079,96.188741,18228,17.031535,1490,1063,427,434,107025,19804,20684
16,473,1406,2.97,121088,3717,96.833119,19631,16.725597,1459,1107,352,473,117371,21043,21641
16,470,1391,2.96,120320,3082,97.371160,18983,16.191849,1241,993,248,470,117238,20347,20780
16,472,1408,2.98,120832,3355,97.144122,19247,16.383633,1350,1113,237,472,117477,20717,21115
16,471,1396,2.96,120576,3005,97.444098,19093,16.239549,1207,973,234,471,117571,20129,20784
16,471,1407,2.99,120576,3052,97.403084,19079,16.234131,1226,986,240,471,117524,20229,20946
16,473,1411,2.98,121088,3937,96.639380,19157,16.352400,1507,1220,287,473,117151,20709,20854
16,472,1405,2.98,120832,3448,97.062632,19084,16.257752,1356,1107,249,472,117384,20370,21119
16,471,1404,2.98,120576,2843,97.585214,19081,16.207011,1103,886,217,471,117733,20023,20886
16,473,1400,2.96,120857,3469,97.044843,18924,16.120898,1285,977,308,473,117388,20156,20822
32,1,6,6.00,1008,0,100.000000,119,11.805556,0,0,0,1,1008,119,125
32,233,698,3.00,119296,16797,83.612523,16085,15.692836,4403,2655,1748,233,102499,22261,21449
32,246,738,3.00,125952,12840,88.648419,17390,15.374142,3697,2485,1212,246,113112,21890,21312
32,251,750,2.99,128512,15150,86.635733,16857,14.870062,3791,2433,1358,251,113362,22007,21645
32,254,760,2.99,130048,16884,85.080061,16755,14.805945,4288,2613,1675,254,113164,22487,22001
32,255,765,3.00,130560,17452,84.570499,16828,14.877816,4176,2599,1577,255,113108,22768,21839
32,249,747,3.00,127488,14199,87.466568,16773,14.805497,3794,2412,1382,249,113289,21429,21042
32,249,747,3.00,127488,14480,87.186748,16971,15.017521,3839,2458,1381,249,113008,21567,21398
32,256,768,3.00,131072,18620,83.441824,16827,14.963718,4428,2674,1754,256,112452,22833,22093
32,244,730,2.99,124928,11800,89.569337,16980,15.009547,3460,2445,1015,244,113128,20754,20352
32,253,758,3.00,129325,16142,85.738141,16905,14.935989,3898,2437,1461,253,113183,22203,21682
32,1,6,6.00,1008,18,98.181818,126,12.727273,3,3,0,1,990,132,133
32,233,698,3.00,119296,12399,88.400984,17981,16.820865,3372,1911,1461,233,106897,22507,23487
32,246,738,3.00,125952,8695,92.584664,19015,16.216516,2641,1764,877,246,117257,22151,22881
32,251,750,2.99,128512,11092,90.553568,18740,15.959802,2998,1789,1209,251,117420,22438,23653
32,254,760,2.99,130048,12201,89.646745,18749,15.909612,3039,1716,1323,254,117847,22689,23923
32,255,765,3.00,130560,13036,88.907798,18839,16.029917,3333,1936,1397,255,117524,22939,23898
32,249,747,3.00,127488,10089,91.406230,18590,15.834888,2814,1769,1045,249,117399,21816,22629
32,249,747,3.00,127488,10132,91.366441,18708,15.941239,2842,1785,1057,249,117356,22122,22723
32,256,768,3.00,131072,13588,88.434170,18785,15.989411,3436,1999,1437,256,117484,23293,23873
32,244,730,2.99,124928,7520,93.594985,18762,15.980172,2337,1643,694,244,117408,21204,21907
32,253,758,3.00,129287,12562,89.237952,18498,15.847505,3183,1900,1283,253,116725,22328,23373
32,1,6,6.00,1008,11,98.896690,126,12.637914,5,5,0,1,997,134,127
32,233,698,3.00,119296,17221,83.129072,16812,16.470242,4667,2799,1868,233,102075,23346,22154
32,246,738,3.00,125952,13124,88.368136,18214,16.143156,3790,2533,1257,246,112828,23048,22282
32,251,750,2.99,128512,15557,86.227259,17855,15.807180,4121,2612,1509,251,112955,23519,22539
32,254,760,2.99,130048,17418,84.535204,17732,15.743585,4344,2673,1671,254,112630,23982,22899
32,255,765,3.00,130560,17895,84.116629,17654,15.669463,4345,2598,1747,255,112665,23786,22662
32,249,747,3.00,127488,15223,86.440119,17731,15.793881,3874,2408,1466,249,112265,22769,21803
32,249,747,3.00,127488,14765,86.901520,17728,15.727048,3887,2462,1425,249,112723,22666,21803
32,256,768,3.00,131072,18839,83.214384,17721,15.789474,4570,2702,1868,256,112233,23981,23030
32,244,730,2.99,124928,11736,89.631776,17770,15.698989,3371,2365,1006,244,113192,21758,20963
32,253,758,3.00,129263,16841,85.019836,17660,15.708669,4160,2539,1621,253,112422,23404,22456
32,1,6,6.00,1008,5,99.501496,130,12.961117,4,4,0,1,1003,134,134
32,233,698,3.00,119296,12324,88.479228,18300,17.107280,3323,1951,1372,233,106972,22962,23986
32,246,738,3.00,125952,8679,92.599320,19504,16.631279,2710,1832,878,246,117273,22792,23406
32,251,750,2.99,128512,11321,90.339702,19070,16.272581,3044,1926,1118,251,117191,23398,23525
32,254,760,2.99,130048,12569,89.301067,19206,16.348454,3123,1863,1260,254,117479,23738,24073
32,255,765,3.00,130560,12779,89.150202,19195,16.297196,3126,1778,1348,255,117781,23275,24369
32,249,747,3.00,127488,10259,91.248752,19016,16.221242,2893,1898,995,249,117229,22346,22886
32,249,747,3.00,127488,10623,90.910024,19110,16.352201,2856,1865,991,249,116865,22736,23167
32,256,768,3.00,131072,13136,88.861756,19104,16.198616,3198,1860,1338,256,117936,23364,24475
32,244,730,2.99,124928,7225,93.861669,19122,16.245975,2262,1606,656,244,117703,21716,22210
32,253,758,3.00,129295,12106,89.669679,18939,16.161073,3090,1876,1214,253,117189,23095,23519
64,1,6,6.00,2032,50,97.477296,275,13.874874,16,11,5,1,1982,299,313
64,112,335,2.99,114688,13124,87.078099,15895,15.650230,3681,2399,1282,112,101564,20921,20162
64,124,368,2.97,126976,13370,88.231255,17412,15.326655,3957,2629,1328,124,113606,22272,21489
64,127,381,3.00,130048,17422,84.531103,16780,14.898869,3934,2416,1518,127,112626,22648,21866
64,142,424,2.99,145408,31589,72.246286,16944,14.886794,5246,2730,2516,142,113819,27050,26661
64,125,374,2.99,128000,15128,86.597207,16768,14.855766,3822,2387,1435,125,112872,21674,21319
64,126,377,2.99,129024,16061,85.782070,16722,14.803077,3759,2410,1349,126,112963,21744,21614
64,129,387,3.00,132096,18829,83.376447,17052,15.054694,4381,2594,1787,129,113267,23342,22730
64,130,390,3.00,133120,20875,81.402290,16800,14.967259,4548,2601,1947,130,112245,23398,22758
64,131,393,3.00,134144,20569,81.889500,16978,14.948712,4383,2638,1745,131,113575,23704,23055
64,129,384,2.98,131157,18449,83.631153,16895,14.990063,4038,2503,1535,129,112708,22805,22334
64,1,6,6.00,2032,63,96.800406,291,14.779076,26,23,3,1,1969,337,315
64,112,335,2.99,114688,8876,91.611537,17756,16.780705,2713,1695,1018,112,105812,21028,22175
64,124,368,2.97,126976,8813,92.541659,19272,16.309674,2594,1679,915,124,118163,22568,23425
64,127,381,3.00,130048,12921,88.968385,18617,15.894713,3180,1764,1416,127,117127,22917,23983
64,142,424,2.99,145408,26978,77.220299,18810,15.882800,5283,2294,2989,142,118430,27318,28873
64,125,374,2.99,128000,10953,90.642221,18720,15.993575,3014,1915,1099,125,117047,22434,23307
64,126,377,2.99,129024,11462,90.250251,18585,15.808680,2952,1714,1238,126,117562,22149,23534
64,129,387,3.00,132096,14350,87.812749,18751,15.924957,3464,1959,1505,129,117746,23423,24260
64,130,390,3.00,133120,16399,85.950257,18659,15.985984,3954,2157,1797,130,116721,24045,24796
64,131,393,3.00,134144,16519,85.956217,18866,16.039107,3916,2091,1825,131,117625,24104,25061
64,129,384,2.98,131182,14406,87.663561,18513,15.853429,3429,1912,1517,129,116776,22933,23822
64,1,6,6.00,2032,69,96.484972,289,14.722364,28,23,5,1,1963,325,319
64,112,335,2.99,114688,13621,86.522802,16606,16.430685,3928,2603,1325,112,101067,22052,20682
64,124,368,2.97,126976,13479,88.123915,18337,16.156374,3839,2531,1308,124,113497,23233,22863
64,127,381,3.00,130048,17965,83.971700,17658,15.754396,4461,2720,1741,127,112083,23790,23034
64,142,424,2.99,145408,32238,71.513652,17808,15.735619,6483,3276,3207,142,113170,28732,27071
64,125,374,2.99,128000,15643,86.077414,17682,15.737337,3961,2555,1406,125,112357,23390,22077
64,126,377,2.99,129024,16713,85.119000,17683,15.744673,4156,2665,1491,126,112311,23479,22027
64,129,387,3.00,132096,19123,83.072947,17854,15.803776,4595,2700,1895,129,112973,24408,23541
64,130,390,3.00,133120,21057,81.209677,17660,15.758993,4986,2911,2075,130,112063,25108,23710
64,131,393,3.00,134144,20440,82.023500,17924,15.763737,4881,2901,1980,131,113704,25220,24112
64,129,384,2.98,131167,18920,83.144316,17561,15.644962,4475,2698,1777,129,112247,23749,22880
64,1,6,6.00,2032,31,98.450775,303,15.142429,17,11,6,1,2001,319,333
64,112,335,2.99,114688,8990,91.494636,18062,17.088308,2683,1677,1006,112,105698,21528,22510
64,124,368,2.97,126976,9316,92.082271,19602,16.659867,2635,1726,909,124,117660,23274,23570
64,127,381,3.00,130048,13209,88.694700,19025,16.283090,3208,1874,1334,127,116839,23775,24247
64,142,424,2.99,145408,27310,76.875138,19282,16.327118,5127,2379,2748,142,118098,28792,29287
64,125,374,2.99,128000,10845,90.743033,19078,16.284410,2749,1647,1102,125,117155,22834,23629
64,126,377,2.99,129024,12416,89.352360,18918,16.223587,3129,1850,1279,126,116608,23080,23277
64,129,387,3.00,132096,14836,87.347774,19164,16.343169,3509,2059,1450,129,117260,24094,24736
64,130,390,3.00,133120,15658,86.669731,18992,16.168633,3680,2012,1668,130,117462,23924,25211
64,131,393,3.00,134144,16470,86.003705,19099,16.230433,3866,2160,1706,131,117674,24523,25323
64,129,384,2.98,131165,13995,88.055816,19012,16.225996,3197,1871,1326,129,117170,23782,24233
128,1,6,6.00,4080,349,90.645939,558,14.955776,106,65,41,1,3731,694,725
128,57,171,3.00,116736,15598,84.577508,15807,15.629140,4045,2308,1737,57,101138,21501,20719
128,62,186,3.00,126976,14116,87.492469,17333,15.357966,3685,2210,1475,62,112860,22029,21656
128,64,192,3.00,131072,19232,82.804006,16673,14.907904,4245,2390,1855,64,111840,22791,22433
128,63,189,3.00,129024,15756,86.089628,16844,14.870926,3835,2244,1591,63,113268,22230,21716
128,63,189,3.00,129024,14738,87.104282,17003,14.877588,3783,2247,1536,63,114286,21659,21362
128,62,186,3.00,126976,13929,87.678576,16758,14.823923,3636,2227,1409,62,113047,20936,21135
128,62,186,3.00,126976,13888,87.719298,16966,15.002476,3782,2344,1438,62,113088,21408,21091
128,62,186,3.00,126976,13742,87.864069,16962,14.979600,3744,2411,1333,62,113234,21380,20872
128,61,183,3.00,124928,13225,88.160569,16713,14.961997,3563,2210,1353,61,111703,20857,20518
128,63,188,2.98,128468,15706,86.071549,16872,14.962487,3976,2376,1600,63,112762,22090,21773
128,1,6,6.00,4080,281,92.603317,597,15.714662,90,62,28,1,3799,737,778
128,57,171,3.00,116736,11518,89.053204,17665,16.788952,3201,1980,1221,57,105218,21973,22869
128,62,186,3.00,126976,9804,91.632813,19016,16.229133,2965,1993,972,62,117172,22444,23310
128,64,192,3.00,131072,14055,87.988925,18667,15.952383,3417,1930,1487,64,117017,23473,24565
128,63,189,3.00,129024,11562,90.156817,18649,15.876624,3084,1896,1188,63,117462,22571,23269
128,63,189,3.00,129024,10099,91.508093,19045,16.014295,2953,1956,997,63,118925,22591,23209
128,62,186,3.00,126976,9725,91.705828,18629,15.888137,2911,1938,973,62,117251,21907,22664
128,62,186,3.00,126976,9601,91.820234,18676,15.911395,2875,1960,915,62,117375,22056,22750
128,62,186,3.00,126976,8893,92.468857,18909,16.013313,2744,1897,847,62,118083,21797,22747
128,61,183,3.00,124928,8563,92.641258,18546,15.937782,2684,1888,796,61,116365,21532,21914
128,63,188,2.98,128639,12399,89.333276,18475,15.893840,3553,2335,1218,63,116240,22493,23193
128,1,6,6.00,4080,269,92.941485,608,15.953818,77,59,18,1,3811,782,723
128,57,171,3.00,116736,16235,83.845932,16498,16.415757,4217,2492,1725,57,100501,22568,21599
128,62,186,3.00,126976,14427,87.181583,18188,16.160073,3633,2308,1325,62,112549,23376,22323
128,64,192,3.00,131072,19082,82.960979,17698,15.803197,4265,2525,1740,64,111990,24394,23549
128,63,189,3.00,129024,16618,85.216092,17728,15.771400,4085,2522,1563,63,112406,23256,22466
128,63,189,3.00,129024,14934,86.910334,17891,15.681480,3800,2452,1348,63,114090,23129,22095
128,62,186,3.00,126976,14617,86.990806,17789,15.832288,3561,2211,1350,62,112359,22851,21528
128,62,186,3.00,126976,14314,87.294740,17752,15.756866,3747,2499,1248,62,112662,22718,21711
128,62,186,3.00,126976,14339,87.269725,17771,15.777231,3580,2315,1265,62,112637,22655,21554
128,61,183,3.00,124928,12807,88.577519,17605,15.701786,3557,2357,1200,61,112121,21893,21316
128,63,188,2.98,128471,16567,85.195346,17484,15.624106,4133,2565,1568,63,111904,23416,22171
128,1,6,6.00,4080,279,92.659826,628,16.521968,88,59,29,1,3801,786,773
128,57,171,3.00,116736,11491,89.081667,17928,17.034538,3040,1823,1217,57,105245,22184,23039
128,62,186,3.00,126976,10077,91.379738,19462,16.648560,2849,1840,1009,62,116899,22970,23530
128,64,192,3.00,131072,14798,87.273165,18890,16.246108,3475,2032,1443,64,116274,24346,24457
128,63,189,3.00,129024,11595,90.125948,19164,16.319648,2884,1830,1054,63,117429,23358,23964
128,63,189,3.00,129024,10145,91.466113,19339,16.267802,2721,1694,1027,63,118879,22783,23496
128,62,186,3.00,126976,9826,91.612463,19005,16.222791,2651,1723,928,62,117150,22327,22694
128,62,186,3.00,126976,9895,91.548586,19143,16.350219,2777,1772,1005,62,117081,22413,23043
128,62,186,3.00,126976,8498,92.827360,19197,16.203008,2429,1585,844,62,118478,22083,22742
128,61,183,3.00,124928,8474,92.723307,18919,16.245900,2480,1650,830,61,116454,21879,22413
128,63,188,2.98,128409,11490,90.172684,18924,16.185564,3092,1877,1215,63,116919,22746,23608
256,1,6,6.00,8176,739,90.063198,1175,15.799381,248,174,74,1,7437,1539,1427
256,33,99,3.00,135168,36495,63.014198,15437,15.644604,7076,2886,4190,33,98673,28075,26983
256,37,111,3.00,151552,39944,64.210451,17227,15.435273,7389,3147,4242,37,111608,30155,29649
256,37,111,3.00,151552,38205,66.293770,16816,14.835858,7171,3165,4006,37,113347,29160,28512
256,36,108,3.00,147456,35129,68.726130,16727,14.891344,6862,3106,3756,36,112327,27593,27694
256,36,108,3.00,147456,34327,69.656764,16768,14.822017,6802,3061,3741,36,113129,27238,26885
256,38,114,3.00,155648,40790,64.486583,17303,15.064689,7564,3188,4376,38,114858,29807,29514
256,35,105,3.00,143360,33134,69.939942,16543,15.008256,6538,3010,3528,35,110226,27053,26203
256,36,108,3.00,147456,32388,71.853165,17210,14.956374,6426,2984,3442,36,115068,27364,26841
256,37,111,3.00,151552,40164,63.942256,16698,14.990843,7122,2959,4163,37,111388,29280,28560
256,38,113,2.97,154973,42825,61.813853,16763,14.947213,7760,3166,4594,38,112148,29565,29356
256,1,6,6.00,8176,474,93.845754,1299,16.865749,180,128,52,1,7702,1511,1536
256,33,99,3.00,135168,32440,68.421463,17240,16.782182,6267,2562,3705,33,102728,28804,29470
256,37,111,3.00,151552,35781,69.093296,18806,16.244137,6601,2701,3900,37,115771,30556,31831
256,37,111,3.00,151552,32768,72.413793,18993,15.989527,6236,2648,3588,37,118784,29853,30952
256,36,108,3.00,147456,30725,73.678800,18562,15.901517,5842,2576,3266,36,116731,29578,29926
256,36,108,3.00,147456,30199,74.245461,18668,15.920585,5792,2558,3234,36,117257,28414,29617
256,38,114,3.00,155648,36084,69.820347,18967,15.863471,6530,2616,3914,38,119564,30559,31584
256,35,105,3.00,143360,28293,75.411717,18480,16.060208,5492,2427,3065,35,115067,27540,28401
256,36,108,3.00,147456,28661,75.873564,18974,15.972053,5712,2468,3244,36,118795,27954,29139
256,37,111,3.00,151552,35699,69.185951,18412,15.892553,6252,2504,3748,37,115853,29550,30653
256,38,113,2.97,155119,37641,67.959107,18675,15.896593,6613,2506,4107,38,117478,30111,31529
256,1,6,6.00,8176,620,91.794600,1257,16.635786,221,167,54,1,7556,1541,1502
256,33,99,3.00,135168,36536,62.957255,16218,16.442939,6153,2834,3319,33,98632,29060,28394
256,37,111,3.00,151552,40497,63.534285,17858,16.080321,6001,3020,2981,37,111055,31890,30330
256,37,111,3.00,151552,37920,66.629119,17980,15.823008,5757,2932,2825,37,113632,30894,30180
256,36,108,3.00,147456,35961,67.746536,17555,15.745101,5787,2964,2823,36,111495,30129,28388
256,36,108,3.00,147456,34507,69.449043,17743,15.708860,5606,2889,2717,36,112949,29191,27708
256,38,114,3.00,155648,41476,63.672354,17935,15.708755,6314,3105,3209,38,114172,31647,29953
256,35,105,3.00,143360,32759,70.380919,17401,15.733131,5312,2707,2605,35,110601,28471,27305
256,36,108,3.00,147456,32780,71.415117,18039,15.730406,5192,2685,2507,36,114676,28943,27740
256,37,111,3.00,151552,40728,63.249838,17400,15.700570,6241,3146,3095,37,110824,30644,29248
256,38,113,2.97,154227,42337,62.161945,17586,15.717222,6396,3030,3366,38,111890,31378,29789
256,1,6,6.00,8176,371,95.246637,1343,17.206919,143,90,53,1,7805,1485,1611
256,33,99,3.00,135168,31957,69.037215,17541,16.995282,3868,1860,2008,33,103211,29029,30121
256,37,111,3.00,151552,35491,69.420391,19402,16.717071,3605,1839,1766,37,116061,31658,32449
256,37,111,3.00,151552,33680,71.426632,19243,16.325336,3596,1847,1749,37,117872,30875,31138
256,36,108,3.00,147456,31195,73.168130,18887,16.245345,3769,1905,1864,36,116261,29353,30645
256,36,108,3.00,147456,29971,74.489509,19099,16.256543,3397,1662,1735,36,117485,28891,29524
256,38,114,3.00,155648,36666,69.183574,19450,16.347010,4040,2011,2029,38,118982,31406,32368
256,35,105,3.00,143360,27184,76.601019,18852,16.227104,3182,1577,1605,35,116176,27870,29025
256,36,108,3.00,147456,28442,76.101971,19204,16.135917,3315,1703,1612,36,119014,28518,29059
256,37,111,3.00,151552,35926,68.929134,18848,16.300832,3644,1878,1766,37,115626,30502,31515
256,38,113,2.97,154245,38188,67.095479,18818,16.214446,3716,1819,1897,38,116057,31476,31856
512,1,6,6.00,16368,1840,87.334802,2311,15.907214,510,317,193,1,14528,3153,2924
512,13,39,3.00,106496,15532,82.925113,14250,15.665538,3924,2251,1673,13,90964,19856,19300
512,16,48,3.00,131072,18952,83.096682,17195,15.336247,4570,2594,1976,16,112120,23441,22934
512,16,48,3.00,131072,17880,84.203831,16893,14.924200,4566,2692,1874,16,113192,22847,22543
512,17,51,3.00,139264,21271,81.972659,17555,14.878001,4983,2758,2225,17,117993,24323,24236
512,16,48,3.00,131072,18962,83.086255,16722,14.915708,4509,2608,1901,16,112110,22626,22318
512,16,48,3.00,131072,17817,84.268244,16780,14.816123,4386,2488,1898,16,113255,22274,22114
512,16,48,3.00,131072,17296,84.798200,17076,15.008438,4167,2481,1686,16,113776,22384,22392
512,16,48,3.00,131072,16892,85.205815,17001,14.889648,4296,2655,1641,16,114180,22377,21867
512,15,45,3.00,122880,14158,86.977797,16355,15.042954,3695,2292,1403,15,108722,20993,20594
512,16,47,2.94,128120,16847,84.859759,16603,14.920960,4279,2609,1670,16,111273,21799,21694
512,1,6,6.00,16368,1500,89.911219,2512,16.895346,436,286,150,1,14868,3132,3147
512,13,39,3.00,106496,11936,87.377327,15761,16.667724,3064,1689,1375,13,94560,20033,20775
512,16,48,3.00,131072,14435,87.623996,18944,16.241844,3484,1836,1648,16,116637,23714,24834
512,16,48,3.00,131072,13441,88.573590,18801,15.983032,3276,1889,1387,16,117631,23369,24359
512,17,51,3.00,139264,16808,86.274254,19394,15.837525,3594,1943,1651,17,122456,24894,25929
512,16,48,3.00,131072,14945,87.130469,18564,15.985946,3386,1808,1578,16,116127,23476,24229
512,16,48,3.00,131072,13864,88.171456,18573,15.846188,3196,1710,1486,16,117208,23011,23960
512,16,48,3.00,131072,12926,89.059300,18757,15.876119,3021,1691,1330,16,118146,23291,23734
512,16,48,3.00,131072,12545,89.415914,19052,16.073975,2938,1742,1196,16,118527,23100,23833
512,15,45,3.00,122880,10468,90.687827,17893,15.917340,2741,1674,1067,15,112412,21241,21861
512,16,47,2.94,128389,13361,88.384567,18232,15.850054,3243,1894,1349,16,115028,22530,23046
512,1,6,6.00,16368,1950,86.475239,2391,16.583437,572,321,251,1,14418,3115,3057
512,13,39,3.00,106496,16172,82.095567,14834,16.423099,3695,2159,1536,13,90324,20816,19728
512,16,48,3.00,131072,18758,83.298609,18147,16.157380,3777,2387,1390,16,112314,24877,23805
512,16,48,3.00,131072,18081,83.997841,17847,15.795063,3938,2504,1434,16,112991,24285,23356
512,17,51,3.00,139264,22386,80.846695,18408,15.749756,4488,2661,1827,17,116878,26088,24816
512,16,48,3.00,131072,18993,83.053917,17609,15.711239,3701,2321,1380,16,112079,24383,23194
512,16,48,3.00,131072,19082,82.960979,17632,15.744263,3492,2353,1139,16,111990,24064,22878
512,16,48,3.00,131072,17484,84.607529,17849,15.713808,3317,2179,1138,16,113588,23937,22898
512,16,48,3.00,131072,17881,84.202808,17755,15.685876,3837,2448,1389,16,113191,23801,22480
512,15,45,3.00,122880,14317,86.812266,17098,15.749381,3172,2066,1106,15,108563,21938,21086
512,16,47,2.94,127741,17272,84.364844,17319,15.677701,3713,2415,1298,16,110469,23133,22316
512,1,6,6.00,16368,1161,92.365358,2611,17.169724,360,230,130,1,15207,3117,3389
512,13,39,3.00,106496,11828,87.505810,16110,17.017366,2741,1522,1219,13,94668,20376,21278
512,16,48,3.00,131072,14518,87.543971,19339,16.592309,2949,1699,1250,16,116554,24445,24904
512,16,48,3.00,131072,13042,88.950267,19218,16.282301,2779,1698,1081,16,118030,24244,24487
512,17,51,3.00,139264,17885,85.265161,19809,16.319956,3436,1909,1527,17,121379,25887,26211
512,16,48,3.00,131072,14385,87.672149,18958,16.246883,3125,1619,1506,16,116687,23668,24412
512,16,48,3.00,131072,13560,88.460753,19132,16.280890,2644,1534,1110,16,117512,23662,24059
512,16,48,3.00,131072,14197,87.852834,18947,16.211337,2832,1582,1250,16,116875,23443,24031
512,16,48,3.00,131072,11368,90.503241,19472,16.266791,2437,1324,1113,16,119704,23166,24264
512,15,45,3.00,122880,9911,91.226797,18351,16.244279,2298,1372,926,15,112969,21605,22236
512,16,47,2.94,127837,12728,88.942654,18684,16.231572,2652,1632,1020,16,115109,23084,23490
1024,1,6,6.00,32752,3603,87.639370,4604,15.794710,1043,691,352,1,29149,6312,5911
1024,6,18,3.00,98304,16274,80.160917,12819,15.627210,3834,2177,1657,6,82030,18419,17750
1024,8,24,3.00,131072,22159,79.654403,16601,15.242441,4755,2670,2085,8,108913,23987,22834
1024,9,27,3.00,147456,24590,79.986327,18302,14.895903,5367,3093,2274,9,122866,26004,24881
1024,8,24,3.00,131072,23041,78.671863,16045,14.852218,4765,2611,2154,8,108031,23299,22152
1024,8,24,3.00,131072,21803,80.046491,16166,14.794681,4694,2601,2093,8,109269,23384,22114
1024,8,24,3.00,131072,20681,81.265683,16457,14.907918,4543,2562,1981,8,110391,22905,22255
1024,9,27,3.00,147456,25493,79.097759,18355,15.049646,5462,3049,2413,9,121963,26303,25142
1024,8,24,3.00,131072,24075,77.499369,16022,14.974252,5141,2826,2315,8,106997,23580,22299
1024,9,27,3.00,147456,27378,77.199820,18002,14.991922,5572,2947,2625,9,120078,26746,25258
1024,8,23,2.88,124264,23124,77.136642,15094,14.923868,4800,2558,2242,8,101140,22480,21119
1024,1,6,6.00,32752,3102,89.537943,5017,16.920742,952,642,310,1,29650,6335,6441
1024,6,18,3.00,98304,12264,85.746165,14409,16.746862,2876,1523,1353,6,86040,18817,19059
1024,8,24,3.00,131072,17875,84.208945,18314,16.178874,3653,1979,1674,8,113197,24426,24466
1024,9,27,3.00,147456,18980,85.226813,20527,15.977303,3776,2077,1699,9,128476,26897,27374
1024,8,24,3.00,131072,18829,83.224789,17838,15.892305,3527,1950,1577,8,112243,24286,24906
1024,8,24,3.00,131072,17928,84.154706,18202,16.087464,3740,2080,1660,8,113144,24246,24216
1024,8,24,3.00,131072,17219,84.876112,18055,15.858168,3684,2004,1680,8,113853,23861,23898
1024,9,27,3.00,147456,20639,83.725368,20261,15.976565,4148,2260,1888,9,126817,26855,27023
1024,8,24,3.00,131072,18889,83.162333,17985,16.031841,3747,1985,1762,8,112183,24079,23875
1024,9,27,3.00,147456,23446,81.093460,19856,16.011612,4673,2436,2237,9,124010,27102,27013
1024,8,23,2.88,124303,18015,83.050768,16910,15.909604,3661,1851,1810,8,106288,22746,23189
1024,1,6,6.00,32752,3749,87.073751,4762,16.418991,1055,657,398,1,29003,6316,6146
1024,6,18,3.00,98304,15394,81.432879,13573,16.370763,2809,1808,1001,6,82910,18959,18627
1024,8,24,3.00,131072,22276,79.524983,17562,16.142138,3193,2004,1189,8,108796,24598,24471
1024,9,27,3.00,147456,24906,79.676867,19332,15.774786,3592,2381,1211,9,122550,27044,26530
1024,8,24,3.00,131072,23905,77.693693,16930,15.797774,3503,2175,1328,8,107167,24552,23741
1024,8,24,3.00,131072,22145,79.669871,17088,15.687571,3497,2146,1351,8,108927,23918,23673
1024,8,24,3.00,131072,21704,80.155073,17295,15.813583,3166,2061,1105,8,109368,24077,23518
1024,9,27,3.00,147456,26251,78.341653,19133,15.785652,3854,2396,1458,9,121205,27165,26667
1024,8,24,3.00,131072,23526,78.124709,16983,15.791382,3348,2122,1226,8,107546,24119,23895
1024,9,27,3.00,147456,27747,76.821292,18805,15.708927,3882,2398,1484,9,119709,27183,26724
1024,8,23,2.88,122877,22901,77.093502,15752,15.755781,3428,2134,1294,8,99976,22918,22733
1024,1,6,6.00,32752,2402,92.085667,5225,17.215815,658,403,255,1,30350,6271,6736
1024,6,18,3.00,98304,11758,86.414161,14745,17.037183,2221,1307,914,6,86546,18773,19532
1024,8,24,3.00,131072,18475,83.591925,18575,16.496887,2050,1263,787,8,112597,24349,25589
1024,9,27,3.00,147456,19666,84.610689,20878,16.337742,1994,1321,673,9,127790,27044,28204
1024,8,24,3.00,131072,19224,82.812388,18289,16.351656,2141,1355,786,8,111848,24209,25547
1024,8,24,3.00,131072,17692,84.395837,18482,16.300935,1869,1185,684,8,113380,23838,25383
1024,8,24,3.00,131072,17112,84.984205,18478,16.214461,1820,1202,618,8,113960,23692,24864
1024,9,27,3.00,147456,20591,83.769361,20631,16.262168,2065,1343,722,9,126865,26803,28294
1024,8,24,3.00,131072,18824,83.229991,18229,16.239933,2041,1362,679,8,112248,23741,25450
1024,9,27,3.00,147456,22987,81.531948,20238,16.259470,2273,1445,828,9,124469,26834,28870
1024,8,23,2.88,123091,19293,81.412937,16814,16.198771,2286,1407,879,8,103798,22608,23711
